"filename", "language", "JavaScript", "comment", "blank", "total"
"d:\CODE-WEB\WEB\user-pc-vite\src\core\match-list\match-card\config\card-template-config.js", "JavaScript", 77, 80, 9, 166
"d:\CODE-WEB\WEB\user-pc-vite\src\core\match-list\match-card\match-list-card-class.js", "JavaScript", 94, 123, 10, 227
"d:\CODE-WEB\WEB\user-pc-vite\src\core\match-list\match-card\module\add-and-remove.js", "JavaScript", 168, 80, 1, 249
"d:\CODE-WEB\WEB\user-pc-vite\src\core\match-list\match-card\module\card-show-offset.js", "JavaScript", 116, 57, 19, 192
"d:\CODE-WEB\WEB\user-pc-vite\src\core\match-list\match-card\module\compute-style-template.js", "JavaScript", 147, 119, 53, 319
"d:\CODE-WEB\WEB\user-pc-vite\src\core\match-list\match-card\module\data-relation-type-1.js", "JavaScript", 186, 100, 42, 328
"d:\CODE-WEB\WEB\user-pc-vite\src\core\match-list\match-card\module\data-relation-type-2.js", "JavaScript", 192, 96, 34, 322
"d:\CODE-WEB\WEB\user-pc-vite\src\core\match-list\match-card\module\data-relation-type-3.js", "JavaScript", 134, 76, 29, 239
"d:\CODE-WEB\WEB\user-pc-vite\src\core\match-list\match-card\module\data-relation.js", "JavaScript", 78, 77, 18, 173
"d:\CODE-WEB\WEB\user-pc-vite\src\core\match-list\match-card\module\fold-csid.js", "JavaScript", 33, 19, 8, 60
"d:\CODE-WEB\WEB\user-pc-vite\src\core\match-list\match-card\module\fold-kaisai-weikaisi.js", "JavaScript", 38, 16, 9, 63
"d:\CODE-WEB\WEB\user-pc-vite\src\core\match-list\match-card\module\fold-tid.js", "JavaScript", 81, 40, 24, 145
"d:\CODE-WEB\WEB\user-pc-vite\src\core\match-list\match-card\module\league-collect.js", "JavaScript", 27, 13, 5, 45
"d:\CODE-WEB\WEB\user-pc-vite\src\core\match-list\match-card\module\match-base-data.js", "JavaScript", 79, 15, 6, 100
"d:\CODE-WEB\WEB\user-pc-vite\src\core\match-list\match-card\module\match-list-card-data-class.js", "JavaScript", 31, 26, 1, 58
"d:\CODE-WEB\WEB\user-pc-vite\src\core\match-list\match-card\module\test-log.js", "JavaScript", 40, 8, 5, 53
"d:\CODE-WEB\WEB\user-pc-vite\src\core\match-list\match-card\module\utils.js", "JavaScript", 17, 9, 3, 29
"Total", "-", 1538, 954, 276, 2768